4
16
a b c d e f g h i j k l m n o p
a b c d e f g h i j k l m n o p
a: a b
b: b c
c: c d
d: d e
e: e f
f: f g
g: g h
h: h i
i: i j
j: j k
k: k l
l: l m
m: m n
n: n o
o: o p
p: p a
3
bill john adrian
seher sabah marsha
john: sabah
adrian: seher
bill: marsha
2
lou liu
zai kai
lou: kai zai
liu:
3
andy simon bob
donna steph mary
simon: donna steph mary
bob: donna mary steph
andy: steph mary donna
